####### ################ 
##.#.E# ##  12 #  #  E # 
#.#.#.# #21 22 23 24 25#
#...#.# #31 32 33 34 35#
#S#...# #41 42 43 44 45#
####### ################