####### ################ 
##...E# #11 12 13 14 15# 
##..### #21  #  #  # 25#
##..### #31 32 33 34 35#
#S....# #41 42 43 44 45#
####### ################